T3SS = (Crc | ExsA | THR_Vfr[3] | THR_PtrC[3] | THR_RsmA[3]) &! (THR_AlgR[3] | THR_cupC[3] | THR_PtrB[3] | THR_MexS[3])
AlgR = AlgT_U
AmpR = THR_AlgT_U[3]
Anr = Anr
BfiR =! RsmA
CbrB_phospho = CbrA
CopR-S = CopR-S
ExsA = PsrA &! ExsD &! PtrA
GacS_phospho =! RetS
MvaU = MvaU
MexS = MexT
MexT = MexS &! THR_AmpR[3]
MvaT = MvaT
NarL = Anr
PrtR =! RecA
PsrA = PsrA
PtrA = CopR-S
PtrB =! PrtR
PtrC = MexT
RetS = HptB_phospho
RocA1_phospho =! RocR
RocR = RocR
Vfr = Vfr
AlgT_U =! ClpXP &! MucA &! THR_AmpR[3]
AlgW = AlgW
asCrcZ = CbrB_phospho
CafA = BfiR
CbrA = CbrA
ClpXP = ClpXP
Crc =! asCrcZ
cupC =! RocA1_phospho &! MvaT
ExsC = PtrA &! ExsE
ExsD =! ExsC
ExsE = PtrA
GacA = GacS_phospho
HptB_phospho = HptB_phospho
MucA =! MucB &! MucP &! AlgW
MucB = MucB
MucD = MucD
MucP = MucD
PA3347_phospho =! HptB_phospho
RecA = RecA
rgRsmY =! CafA &! THR_PA3347_phospho[3]
rgRsmZ = GacA &! NarL &! (MvaT & MvaU)
RsmA =! rgRsmY &! rgRsmZ
