BIOFILM = ((ALGINATE & Pel & Psl) | (Pel & Psl) | (MifR & BfmR & BfiR) | (cupB & cupC & cupA & MorA ) | (BfiS_phospho & PA3347_phospho & MOD_PhoP[3] & Crc & Pel)) &! AmpR &! Fur &! MOD_FLAGELLA[3] &! MOD_SWARMING[3]
ALGINATE = (Alg44 | AlgD | AlgC) &! (AlgZ_FimS | THR_PhoP[3])
FLAGELLA = CheIV
Fur = Fur
SWARMING = THR_PA3347_phospho[3]
Alg44 = c-di-GMP
AlgB = AlgT_U
AlgR = AlgT_U
AmpR = THR_AlgT_U[3]
AmrZ = AlgT_U
Anr = Anr
BfiR =! RsmA
BfmR = BfmR
CbrB_phospho = CbrA
FleQ = c-di-GMP
GacS_phospho =! RetS
Las_QS = Las_QS
MvaU = MvaU
MifR = MifR
MorA = MorA
MucR = MucR
MvaT = MvaT
NarL = Anr
PhoP = CbrA
RetS = HptB_phospho
RocA1_phospho =! RocR
RocR = RocR
SadB = c-di-GMP
WspR =! WspF
AlgC = AlgR
AlgD = AlgB | AmrZ | AlgR
AlgT_U =! ClpXP &! MucA &! THR_AmpR[3]
AlgW = AlgW
AlgZ_FimS = AlgZ_FimS
asCrcZ = CbrB_phospho
BfiS_phospho = BfiS_phospho
BifA = BifA
CafA = BfiR
CbrA = CbrA
c-di-GMP = ((WspR | MucR) & SadC) &! BifA
CheIV = SadB
ClpXP = ClpXP
Crc =! asCrcZ
cupA =! MvaT
cupB =! RocA1_phospho &! MvaT
cupC =! RocA1_phospho &! MvaT
GacA = GacS_phospho
HptB_phospho = HptB_phospho
MucA =! MucB &! MucP &! AlgW
MucB = MucB
MucD = MucD
MucP = MucD
PA3347_phospho =! HptB_phospho
Pel = (THR_rgRsmY[3] & THR_rgRsmZ[3]) | SadB &! THR_TpbA[3] &! FleQ &! RsmA
Psl = THR_rgRsmY[3] & THR_rgRsmZ[3] &! RsmA
rgRsmY =! CafA &! THR_PA3347_phospho[3]
rgRsmZ = GacA &! NarL &! (MvaT & MvaU)
RsmA =! rgRsmY &! rgRsmZ
SadC = SadC
TpbA = Las_QS
WspF = WspF
