IN1 = IN1
AI1 = IN1
lasR = AI1 | HSL
LasR = lasR
LasR-bound = LasR & HSL
IN2 = IN2
rsaL = IN2
RsaL = rsaL
lasI = LasR-bound &! RsaL
LasI = lasI
HSL = AI1 | LasI
lasREG = THR_LasR-bound[3]
pqsR = (THR_LasR-bound[3] | PQS) &! THR_RhlR-bound[3]
PqsR = pqsR
PqsR-bound = PqsR & PQS
pqsABCDH = (PqsR-bound | LasR-bound | THR_iqsRec-bound[3])  &! THR_RhlR-bound[3]
PqsABCDH = pqsABCDH
PQS = PqsABCDH & phnAB
phnAB = PqsR | THR_iqsRec-bound[3]
pqsREG = THR_PqsR-bound[3]
rhlR = BHL | THR_LasR-bound[3]
RhlR = rhlR
RhlR-bound = RhlR & BHL
rhlI = THR_LasR-bound[3] | THR_PqsR-bound[3] | THR_iqsRec-bound[3] | RhlR-bound
RhlI = rhlI
BHL = RhlI
rhlREG = THR_RhlR-bound[3]
pyochelin_biosynthesis = IQS
IQS = pyochelin_biosynthesis
iqsRec = THR_LasR-bound[3] | IQS
iqsRec-bound = iqsRec & IQS
iqsREG = THR_iqsRec-bound[3]
